[
  {
    "type": "mapgen",
    "om_terrain": [ [ "container_yard_inland_base_1" ] ],
    "object": {
      "fill_ter": "t_floor",
      "rows": [
        "1    1    1    1        ",
        "                        ",
        "                        ",
        "                        ",
        "                        ",
        "                        ",
        "                        ",
        "                        ",
        "                        ",
        "                        ",
        "                        ",
        "                        ",
        "                        ",
        "                        ",
        "                        ",
        "                        ",
        "                        ",
        "                        ",
        "                        ",
        "                        ",
        "                        ",
        "                        ",
        "                        ",
        "                        "
      ],
      "flags": [ "ALLOW_TERRAIN_UNDER_OTHER_DATA" ],
      "nested": {
        "1": {
          "chunks": [
            [ "containers_food", 1 ],
            [ "containers_electronics", 1 ],
            [ "containers_appliances", 1 ],
            [ "containers_antiques", 1 ],
            [ "containers_books", 1 ]
          ]
        }
      }
    }
  },
  {
    "type": "mapgen",
    "nested_mapgen_id": "containers_food",
    "object": {
      "mapgensize": [ 13, 13 ],
      "rows": [
        "             ",
        " # #         ",
        " # #         ",
        " # #         ",
        " # #         ",
        " # #         ",
        " # #         ",
        " # #         ",
        " # #         ",
        " # #         ",
        " # #         ",
        " # #         ",
        "1            "
      ],
      "flags": [ "ALLOW_TERRAIN_UNDER_OTHER_DATA" ],
      "vehicles": { "1": { "vehicle": "shipping_container_20", "chance": 100, "rotation": 0 } },
      "furniture": {
        "#": [ [ "f_null", 5 ], [ "f_crate_c", 90 ], [ "f_cardboard_box", 5 ] ]
      },
      "items": {
        "#": { "item": "cannedfood", "chance": 95, "repeat": [ 10, 20 ] }
      }
    }
  },
  {
    "type": "mapgen",
    "nested_mapgen_id": "containers_electronics",
    "object": {
      "mapgensize": [ 13, 13 ],
      "rows": [
        "             ",
        " # #         ",
        " # #         ",
        " # #         ",
        " # #         ",
        " # #         ",
        " # #         ",
        " # #         ",
        " # #         ",
        " # #         ",
        " # #         ",
        " # #         ",
        "1            "
      ],
      "flags": [ "ALLOW_TERRAIN_UNDER_OTHER_DATA" ],
      "vehicles": { "1": { "vehicle": "shipping_container_20", "chance": 100, "rotation": 0 } },
      "furniture": {
        "#": [ [ "f_null", 5 ], [ "f_crate_c", 90 ], [ "f_cardboard_box", 5 ] ]
      },
      "items": {
        "#": { "item": "consumer_electronics", "chance": 95, "repeat": [ 10, 20 ] }
      }
    }
  },
  {
    "type": "mapgen",
    "nested_mapgen_id": "containers_appliances",
    "object": {
      "mapgensize": [ 13, 13 ],
      "rows": [
        "             ",
        " # #         ",
        " # #         ",
        " # #         ",
        " # #         ",
        " # #         ",
        " # #         ",
        " # #         ",
        " # #         ",
        " # #         ",
        " # #         ",
        " # #         ",
        "1            "
      ],
      "flags": [ "ALLOW_TERRAIN_UNDER_OTHER_DATA" ],
      "vehicles": { "1": { "vehicle": "shipping_container_20", "chance": 100, "rotation": 0 } },
      "furniture": {
        "#": [
          [ "f_null", 5 ],
          [ "f_dishwasher", 5 ],
          [ "f_home_furnace", 5 ],
          [ "f_washer", 5 ],
          [ "f_oven", 5 ],
          [ "f_dryer", 5 ],
          [ "f_diesel_generator", 5 ],
          [ "f_fridge", 1 ],
          [ "f_glass_fridge", 1 ],
          [ "f_glass_fridge_double", 1 ],
          [ "f_heavy_duty_fridge", 1 ],
          [ "f_display_fridge", 1 ],
          [ "f_minifreezer", 1 ],
          [ "f_freezer", 1 ],
          [ "f_heavy_duty_freezer", 1 ],
          [ "f_glass_freezer", 1 ],
          [ "f_display_freezer", 1 ],
          [ "f_exercise", 1 ],
          [ "f_ball_mach", 5 ],
          [ "f_arcade_machine", 5 ],
          [ "f_pinball_machine", 5 ],
          [ "f_ergometer", 1 ],
          [ "f_ergometer_mechanical", 1 ],
          [ "f_treadmill", 1 ],
          [ "f_treadmill_mechanical", 1 ],
          [ "f_piano", 5 ],
          [ "f_speaker_cabinet", 5 ],
          [ "f_training_dummy_light", 1 ],
          [ "f_training_dummy_heavy", 1 ],
          [ "f_archery_target_box", 1 ],
          [ "f_archery_target_bale", 1 ],
          [ "f_toilet", 5 ],
          [ "f_water_heater", 1 ],
          [ "f_water_heater_family", 1 ],
          [ "f_water_purifier", 1 ]
        ]
      }
    }
  },
  {
    "type": "mapgen",
    "nested_mapgen_id": "containers_antiques",
    "object": {
      "mapgensize": [ 13, 13 ],
      "rows": [
        "             ",
        " # #         ",
        " # #         ",
        " # #         ",
        " # #         ",
        " # #         ",
        " # #         ",
        " # #         ",
        " # #         ",
        " # #         ",
        " # #         ",
        " # #         ",
        "1            "
      ],
      "flags": [ "ALLOW_TERRAIN_UNDER_OTHER_DATA" ],
      "vehicles": { "1": { "vehicle": "shipping_container_20", "chance": 100, "rotation": 0 } },
      "furniture": {
        "#": [ [ "f_null", 5 ], [ "f_crate_c", 90 ], [ "f_cardboard_box", 5 ] ]
      },
      "items": {
        "#": { "item": "antique", "chance": 95, "repeat": [ 1, 5 ] }
      }
    }
  },
  {
    "type": "mapgen",
    "nested_mapgen_id": "containers_books",
    "object": {
      "mapgensize": [ 13, 13 ],
      "rows": [
        "             ",
        " # #         ",
        " # #         ",
        " # #         ",
        " # #         ",
        " # #         ",
        " # #         ",
        " # #         ",
        " # #         ",
        " # #         ",
        " # #         ",
        " # #         ",
        "1            "
      ],
      "flags": [ "ALLOW_TERRAIN_UNDER_OTHER_DATA" ],
      "vehicles": { "1": { "vehicle": "shipping_container_20", "chance": 100, "rotation": 0 } },
      "furniture": {
        "#": [ [ "f_null", 5 ], [ "f_crate_c", 90 ], [ "f_cardboard_box", 5 ] ]
      },
      "items": {
        "#": { "item": "antique", "chance": 95, "repeat": [ 1, 5 ] }
      }
    }
  }
]
